Zelda
An Interactive Fiction by Roboninja101
Release 1 / Serial number 141007 / Inform 7 build 6L38 (I6/v6.33 lib 6/12N) SD

Middle Hallway
middle hallay, exits are to the west and south

>w
West Corridor

>w
King's Room
The King's Room is even more magnificiant than Zelda's Room. Theres a desk, a wardrobe, a bed, and other pieces of furniture

>e
West Corridor

>e
MIddle Hallway

>s
Southern Corridor

>s
Zelda's Room
you enter an elegant room with the most beautiful furnishings and furniture you've ever seen. a dresser and shelf are on your left, a Painting and a Hylian Crest Quilt are on your right, and a bed is in front of you.

You can see a Dresser (closed) and a Shelf (closed) here.

>x shelf
An elegant wooden bookshelf with two glass doors filled with storybooks, history books, trinkets and a book archiving the entire lineage of Hyrule

>open shelf
You open the Shelf, revealing Storybooks, History Books, Trinkets and a Hyrule Heritage Book.

>take hyrule heritage book
Taken.

>x heritage book
This book has every record of the history of Hyrule spanning from the Era of Creation, The God Era, the Twilight and Shadow Era, and the Era of Great Voyage.

You notice a bookmark fall out of the Hero of Time Era chapter. Upon Further investigation, you notice pages upon pages of notes on the Ocarina of Time.

>x shelf
An elegant wooden bookshelf with two glass doors filled with storybooks, history books, trinkets and a book archiving the entire lineage of Hyrule

In the Shelf are Storybooks, History Books and Trinkets.

>open shelf
That's already open.

>take storybooks
Why would you take it? You have no use for it.

>i
You are carrying:
  a Hyrule Heritage Book

>take storybooks
Why would you take it? You have no use for it.

* * *

>s
Southern Corridor

>ss
That's not a verb I recognise.

>s
Zelda's Room
you enter an elegant room with the most beautiful furnishings and furniture you've ever seen. a dresser and shelf are on your left, a Painting and a Hylian Crest Quilt are on your right, and a bed is in front of you. You also notice Zelda staring out the window.

>take all
There are none at all available!

>get all
There are none at all available!

>talk to zelda
Ugh, what was it?! It seems so familiar, but i just can't remember that song! Hmm? Oh, Hi Link. Sorry, I've been trying to remember a song for a whle now, and it's really bugging me. Maybe could you figure help me remember what it was?

* * *

>w
West Corridor

>e
MIddle Hallway

>n
You can't go that way.

I beg your pardon?

>s
Southern Corridor

>s
Zelda's Room
you enter an elegant room with the most beautiful furnishings and furniture you've ever seen. a dresser and shelf are on your left, a Painting and a Hylian Crest Quilt are on your right, and a bed is in front of you. You also notice Zelda staring out the window.

>x dresser
A beautiful mahogany dresser with a gold Hylian Crest inlayed on the top of the dresser.

>x shelf
An elegant wooden bookshelf with two glass doors filled with storybooks, history books, trinkets and a book archiving the entire lineage of Hyrule

>get books
You can't see any such thing.

>get all
There are none at all available!

>n
Southern Corridor

>n
MIddle Hallway

>e
You can't go that way.

>w
West Corridor

* * *

>w
King's Room
The King's Room is even more magnificiant than Zelda's Room. Theres a desk, a wardrobe, a bed, and other pieces of furniture

>x all
You can't use multiple objects with that verb.

>x wardrobe
The King's wardrobe, made of dark oak and it's probably the most georgous wardrobe you've ever seen.

>open wardrobe
Maybe it's not a good idea to open the King's wardrobe...

>x bed
A bed fit for a king... oh wait. it is for a king. Between the pillows, you notice the missing ocarina wedged in there.

>get ocarina
Taken.

>x chair
You can't see any such thing.

>e
West Corridor

* * *

>s
Zelda's Room
you enter an elegant room with the most beautiful furnishings and furniture you've ever seen. a dresser and shelf are on your left, a Painting and a Hylian Crest Quilt are on your right, and a bed is in front of you. You also notice Zelda staring out the window.

>x zelda
Zelda is the princess of Hyrule. She has golden brown hair, pointed ears,   blue eyes, and she's wearing a pink and white dress. you've saved her from Ganon, and she's the love of your life. She appears frusturated and flustered over something.

>give ocarina
(to Zelda)
Zelda doesn't seem interested.

>get dress
You can't see any such thing.

* * *

Zelda
An Interactive Fiction by Roboninja101
Release 1 / Serial number 141007 / Inform 7 build 6L38 (I6/v6.33 lib 6/12N) SD

Middle Hallway
middle hallay, exits are to the west and south

>e
East Corridor

>e
You can't go that way.

>w
East Corridor

>w
MIddle Hallway

>w
West Corridor

>w
King's Room

>w
You can't go that way.

>e
West Corridor

* * *

>s
Zelda's Room
you enter an elegant room with the most beautiful furnishings and furniture you've ever seen. a dresser and shelf are on your left, a Painting and a Hylian Crest Quilt are on your right, and a bed is in front of you.

You can see a Dresser (closed) and a Shelf (closed) here.

>open dresser
You open the Dresser.

>x shelf
An elegant wooden bookshelf with two glass doors filled with storybooks, history books, trinkets and a book archiving the entire lineage of Hyrule

>open
What do you want to open?

>open shelf
You open the Shelf, revealing Storybooks and a history books.

* * *

Zelda
An Interactive Fiction by Roboninja101
Release 1 / Serial number 141007 / Inform 7 build 6L38 (I6/v6.33 lib 6/12N) SD

Middle Hallway
middle hallay, exits are to the west and south

>s
Southern Corridor

* * *

>s
Zelda's Room
you enter an elegant room with the most beautiful furnishings and furniture you've ever seen. a dresser and shelf are on your left, a Painting and a Hylian Crest Quilt are on your right, and a bed is in front of you. You also notice Zelda staring out the window.

>x shelf
An elegant wooden bookshelf with two glass doors filled with storybooks, history books, trinkets and a book archiving the entire lineage of Hyrule

>n
Southern Corridor

>s
Zelda's Room
you enter an elegant room with the most beautiful furnishings and furniture you've ever seen. a dresser and shelf are on your left, a Painting and a Hylian Crest Quilt are on your right, and a bed is in front of you. You also notice Zelda staring out the window.

>open shelf
You open the Shelf, revealing Storybooks, History Books, Trinkets and a Hyrule Heritage Book.

>take all
Storybooks: Why would you take it? You have no use for it.
History Books: Why would you take it? You have no use for it.
Trinkets: You examine the trinkets, think about which one to take, but then you notice that the stand for an ocarina is missingHyrule Heritage Book: Taken.

>x heritage book
This book has every record of the history of Hyrule spanning from the Era of Creation, The God Era, the Twilight and Shadow Era, and the Era of Great Voyage.

You notice a bookmark fall out of the Hero of Time Era chapter. Upon Further investigation, you notice pages upon pages of notes on the Ocarina of Time, incuding a song written in.

>talk to zelda
Ugh, what was it?! It seems so familiar, but i just can't remember that song! Hmm? Oh. Hi Link. Sorry, I've been trying to remember a song for a whle now, and it's really bugging me. Maybe could you figure help me remember what it was?

>talk to zelda
Hmm, what was that song? Do you know it?

>talk to zelda
Hmm, what was that song? Do you know it?

>give heritage boo to zleda
You can only do that to something animate.

>give book to zelda
Oh, Maybe it's in here... Nope, Nope, Nope, Nope, YES!! That's it! But wait, now where's my Ocarina? Wow I am careless today.

>n
Southern Corridor

* * *

>n
MIddle Hallway

>w
West Corridor

* * *

>w
King's Room
The King's Room is even more magnificiant than Zelda's Room. Theres a desk, a wardrobe, a bed, and other pieces of furniture

>open desk
You open Desk, revealing a Wedding Ring.

>take ring
Taken.

>e
West Corridor

* * *

>e
MIddle Hallway

>e
East Corridor

>ee
That's not a verb I recognise.

>ee
That's not a verb I recognise.

>e
Link's Room

>e
You can't go that way.

>e
You can't go that way.

>ee
That's not a verb I recognise.

>e
You can't go that way.

* * *

Zelda
An Interactive Fiction by Roboninja101
Release 1 / Serial number 141007 / Inform 7 build 6L38 (I6/v6.33 lib 6/12N) SD

Middle Hallway
middle hallay, exits are to the west and south

>e]
That's not a verb I recognise.

>e
You can't go that way.

* * *

>w
West Corridor

>w
King's Room
The King's Room is even more magnificiant than Zelda's Room. Theres a desk, a wardrobe, a bed, and other pieces of furniture

On King's bed is an Ocarina of Time.